татар - татарин, татарский
рәсем - рисунок, картина
бераз - немного, несколько
эремә - раствор
арзан - дешёвый, недорогой
низаг - ссора, конфликт
юнәлү - направляться, взять
күбәю - множиться, умножиться
елмаю - улыбаться, улыбнуться
борау - бурав, сверло
кисеп - вырез, продавать
фарыз - религиозное, предписание
өтелү - страд, обгорать
юньле - порядочный, толковый
каган - каган
җырчы - певец, певица
өстен - господствующий, доминирующий
сумса - сумса, национальное
күнче - кожевенник, специалист
бишек - колыбель, люлька
калта - мошна, карман
качыр - лошак
лычма - насквозь, мокрый
ярашу - приспосабливаться, соответствовать
үбешү - целоваться
сөрем - копоть, перен
тышта - снаружи, извне
ыржык - нескромно, улыбающийся
кешән - лошади
кайчы - ножницы, стропило
каеры - кайры
челлә - жаркая, перен
черем - дрёма, дремота
үкенү - каяться, сожалеть
аръяк - сторона, противоположная
андыз - девясил
боегу - унывать, печалиться
тойгы - ощущение, чутьё
бүсер - грыжа, грыжевой
өмәче - участник, коллективной
төшмә - нисходящий
кизәк - кизяк, кизяковый
умыру - отламывать, отрывать
койты - плохой, нехороший
рәсем - рисунок, картина
җимле - имеющий, зерно
инәле - игольчатый, игличтый
гаилә - семья, семейство
сазлы - болотистый, заболоченный
орлык - семенной, семя
тупыл - тополь, тополиный
итләч - мясистый
черки - комар, комариный
шырпы - спичка, спичечный
төрем - завёртка, обёрточный
йомыш - поручение, задание
шулпа - бульон, бульонный
мулла - мулла, служитель
энәле - иглистый, игольчатый
такыя - скуфья, такия
купшы - щеголеватый, щегольской
кәсеп - занятие, ремесло
батыр - герой, богатырь
көчек - щенок
җомга - пятница, пятничный
ыштыр - портянка, онуча
киенү - одеваться, одеться
ирсәк - похотливая
төрмә - тюрьма, тюремный
яулау - прям, перен
чәчмә - прозаический
кисәү - головешка, обгорелое
аврал - авральный
төбәү - целить, прицелиться
ярәшү - помолвить
пычак - ножевой, перен
этләү - измаять, измучить
даган - качели
узышу - состязаться, гонке
румын - румын, румынский
торыш - положение, состояние
өшетү - обмораживать, отморозить
чырай - лицо, мина
сызым - чертёж, чертёжный
нигез - фундамент, фундаментный
сасык - вонючка
алман - немецкий
кытай - китаец, китайский
дәвам - продолжение, дәвамында
абыну - спотыкаться, споткнуться
җепшү - подтаивать, подтаять
сылау - мазать, обмазывать
кәрлә - карлик, карликовый
көчкә - насилу
әйрән - айран, напиток
сәлам - привет, приветствие
күрше - сосед, соседский
меңәр - тысяче
шәүлә - блик, отсвет
әйбәт - хороший, хорошо
әтраф - сторона, окружность
үрләү - взбираться, подниматься
мирза - мурза, мирза
бүлмә - комната, кабинет
оерша - комки, комочки
китек - отколотый, отломанный
төгәл - точный, точно
нәҗес - нечистый, поганый
субай - свайный
мичәү - постромки, постромочный
буылу - страд, душиться
комак - крыса, крысиный
богыл - сена
балык - рыбий, рыбный
булат - булат, булатный
тәтәй - старшая, сестра
туган - прям, перен
дөмбе - ботало
җәбер - гнёт, угнетение
актүш - белобрюшка, птица
дегет - дёготь, дегтевой
купшу - слегка, отдираться
тәпәч - дубинка, палка
очыну - летать, махать
хәмер - алкоголь, спиртное
туфан - всемирный, потоп
җәһәт - быстро, живо
җенси - половой, плотский
кәбап - кебаб, жаркое
гөслә - гусли, гуслярный
күбәк - рукоять, цепа
кичкә - вечеру, вечер
астан - снизу, исподнизу
хәрби - военный, воинский
олтан - подошва, подмётка
риялы - лицемерный, двуличный
кәйлә - кайло
ягылу - страд, мазать
гадел - справедливый, честный
атама - название, наименование
үртәү - поддразнивать, дразнить
көрән - коричневый, бурый
масаю - кичиться, возгордиться
антлы - клятвенный
мүкле - мшистый
тәүбә - раскаяние, покаяние
тамга - знак, метка
йолым - выкуп, откуп
чинау - визжать, пищать
алама - худой, старый
кәләш - невеста, сговорённая
бутау - мешать, помешать
ләүкә - полок, бане
эшсез - бездельник, лентяй
таулы - гористый, холмистый
ярсып - разъярённо, возбуждённо
чәчәк - цвет, цветок
амбар - житница
сарут - пырей
ялтыр - блестящий, сверкающий
жулау - жужжать, прожужжать
арада - пока, время
татым - привкус
шаять - вводн, наверно
чалым - сходство, черты
көзән - хорь, хорёк
черек - гнилой, гниль
испан - испанец, испанский
сукыр - прям, перен
болай - таким, образом
көрәк - лопата, лопатка
оеткы - закваска, перен
мунча - банный
чаклы - величиной
яһүди - еврейский
бәбәк - молодая, ветвь
салпы - обвислый, опущенный
калай - жесть, жестяной
яшерү - прям, перен
юырту - бежать, рысью
керпе - ежовый
тутык - ржавчина, ржавый
тынчу - затхлый, спёртый
авышу - клониться, наклониться
чарык - колесо, мельничное
печән - сенной, сенокос
калын - толстый, плоских
факыр - бедняга, бедный
сакчы - сторож, страж
баллы - медолвый, сладкий
дебет - пуховый
һөҗүм - нападение, набег
бурят - бурят, бурятский
алкын - полноводный, стремительный
җиһаз - обстановка, мебель
берәү - кто-то, некий
казна - казна, казённый
дорфа - грубый, невежливый
ятимә - девочка-сирота
бәлеш - бэлеш, нацииональное
кабык - корка, раны
утыру - садиться, сидеть
түтәй - тётя, тётка
юлыгу - натыкаться, встречать
ялкау - ленивый, лениво
көнче - ревнивый, ревнивец
бәлҗә - пазник, поперечный
мәкле - маковый, маком
тубал - лукошко, кузов
назлы - нежный, ласковый
гомер - жизнь, жизненный
имгеч - присоска, сосочек
камыр - тесто, мучной
ашлау - удобрять, удобрить
инсаф - воспитанность, благовоспитанность
кавем - родня, племя
сусыл - сочный, водянистый
тәхет - трон, престол
иссез - недушистый, бесчувственный
калош - галоши, галошный
ымлык - междометие
микән - ли...
шөреп - шуруп, шурупный
шомлы - таинственный, страшный
ончыл - мучнистый
русча - по-русски
җефет - супруга, супруг
армут - груша
үтерү - убивать, умерщвлять
читән - плетень, изгородь
гөман - предположение, гипотеза
ишелү - рушиться, рухнуть
парча - узор, развод
холык - характер
иясез - бесхозный, бездомный
кулай - удобный, сподручный
күркә - шишка, сосны
кетәк - курятник, птичник
юаныч - утешение, забава
даирә - круг, окружность
ашату - кормить, покормить
имезү - кормить, накормить
ләтчә - ласка, зверёк
кызык - интересный, любопытный
көлчә - лепёшки
уенчы - игрок, музыкант
харап - предик, страх
бикле - запертый, замкнутый
пеләш - плешь, лысина
икмәк - хлебный, хлеба
нинди - какой, каков
моңлы - печальный, грустный
укалы - вышитый, канителью
актык - последний, крайний
савыр - лошади, кожа
кузак - стручок, стручковый
сөреш - течение, направление
абзый - уважительное, обращение
милек - собственность, имущество
очкыр - летун, искусно
сызык - черта, линия
төрпе - прям, перен
абзар - хлев, стойло
каене - деверь, младший
тәгам - пища, яства
ишкән - витой, браслет
хөсет - зависть
богау - прям, перен
таяну - опираться, облокотиться
ахшам - молитва, совершаемая
көлтә - сноп
үксез - сирота, сиротский
кәшеф - открытие, изобретение
хилаф - противный, противоречащий
келәт - амбар, клеть
таифә - группа, племя
тупас - грубый, грубо
камка - божья, коровка
агулы - ядовитый, ядоносный
ләүхә - картина, вывеска
тәңкә - монета, рубль
ябышу - липнуть, прилепляться
ярчык - осколок
сүсән - тимофеевка, метлица
оялык - гнездовка
туташ - обращение, незамужней
чулпы - этногр, накосник
шыбын - шомпол
элүле - развешанный, повешенный
шымчы - сыщик, лазутчик
аксау - хрометь, охрометь
өтүче - палильщик
оячык - ячейка
акула - акула, акулий
бәндә - человек, человечек
кайры - корьё, корьевой
күмер - уголь, угольный
әшәке - плохой, дрянной
оҗмах - прям, перен
юашаю - юашлану
бурка - бурка, одежда
аталу - называться, назваться
борча - блоха, блошиный
монда - здесь
аслык - подставка, поддон
өстән - сверху, перен
казык - колышек
юалык - место, растёт
белән - со, вместе
калак - ложка, металлическая
коткы - подстрекательство, провокация
үзара - между, собой
әлегә - пока, покамест
сәфәр - поездка, путешествие
оялту - стыдить, пристыдить
сирәк - редкий, редко
чирәп - черепица, черепичный
тыелу - запрещаться, воздерживаться
басым - давление, напор
котлы - счастливый, благодатный
соскы - совок, совковый
чулак - сухорукий, однорукий
гауга - галдёж, раздор
кабак - тыква, глазное
ватык - разбитый, битый
ишкеч - гребной
тугым - ободочный
махау - проказа, прокажённый
карыш - пядь, вершок
элмәк - петля, петелька
хөтбә - проповедь, хутба
юртыш - аллюр
нөсхә - экземпляр
аслам - заклад, залог
иңлек - ширина
шәңгә - шаньга, шанежка
сакал - борода
ярышу - соревноваться, состязаться
өзгеч - выключатель, разъединитель
тунау - обдирать, сдирать
ешлау - уплотнять, уплотнить
гамәл - дело, действие
телем - ломоть, ломтик
йөзек - перстень
ургыл - быстрина, стремнина
курай - полый, стебель
башта - сначала, сперва
мөдир - заведующий, управляющий
чучка - хрюшка, свинья
залим - жестокий, бесчеловечный
берәр - одному, какой-нибудь
җанаш - душечка, душенька
каюлы - простроченный, окаймлённый
күпер - мостовой
сәүдә - торговля, торговый
чачак - бахрома, кисточка
сидек - мочевой
ничәү - сколько
чикле - ограниченный, имеющий
җебен - унылый
гаҗиз - бессильный, немощный
гадәт - привычка, навык
ябыгу - худеть, истощать
таган - таган, таганок
җилле - ветреный, ветрено
игүле - возделываемый, земле
кытыр - бугорок, утолщение
ымсыз - молча, молчаливый
бәхет - счастье, удел
җебек - унылый
аерма - различие, разница
күсәк - прям, перен
килен - сноха, невестка
тезмә - цепь, цепочка
суешу - резаться
касык - паховый
кайту - возвращаться, возвратиться
уйгыч - резак
бүтән - другой, иной
үткән - прошлый, минувший
җиңел - лёгкий, весу
чорма - чердак, подволока
җәйге - летний
сулыш - прям, перен
өрлек - балка, перекладина
алгыр - шустрый, юркий
колак - ушной, деталь
үсенү - возгордиться, воображать
очыру - пускать, пустить
тешле - зубчатый, перен
соңгы - последний, последнее
томау - насморк, насморочный
башлы - умный, способный
сузаю - удлиняться, расти
сунар - охота
кадәр - вплоть, сколько
укучы - ученик, учащийся
кәүсә - ствол, ствольный
кишер - морковь, морковный
җиләк - ягода, ягодный
хөрти - предик, плохой
корым - сажа, копоть
фәтва - фетва, разрешение
чокыр - рытвина, воронка
казый - кадий, казий
ябылу - страд, закрываться
савым - удой, надой
тыгын - тесный
керән - хреновый
һәммә - весь, каждый
чыдау - терпеть, вытерпеть
суыру - веять, провеять
гөнаһ - грех
димәк - вводн, следовательно
якташ - земляк
туару - распрягать
урату - понуд, отгараживать
гүяки - будто, будто
ясмин - жасмин, жасминовый
айсыз - безлунный
фикер - мысль, намерение
учлап - пригоршнями, горстями
тотка - ручка, рукоятка
зәһәр - отрава, ядовитый
бүләк - подарок, подарочный
сабын - мыльный, мыловаренный
саумы - здравствуйте
җайлы - удобный, удобно
гөблә - үләң, бете
исбат - доказательство
кырык - сорок, сороковой
тубыр - желвак, животных
тонык - прозрачный, чистый
илдәш - соотечественник, земляк
гафил - невнимательный, небрежный
көздә - осенью
тавис - павлин, павлиний
ансат - лёгкий, нетрудный
кәкре - кривой, гнутый
көенү - печалиться, горевать
тузан - пылевой, пыльца
ярылу - понуд, раскалываться
җелек - костный
вәкил - представитель, поверенный
олагу - пропадать, пропасть
тотык - заложник
этешү - толкаться, многих
һөнәр - ремесло, профессия
бурау - рубить, срубать
нөктә - обида
турау - нарезать, разрезать
ислам - ислам, исламский
чиста - чистый, опрятный
аклык - белизна
оялап - em>нар, гнёздами
бүсәү - разваливать, развалить
санау - считать, счесть
кибер - надменность
чалгы - коса
хәлчә - возможности
тарту - тянуть, себе
артык - слишком, очень
апара - опара, пойло
төшем - прибыль, выручка
күмәк - коллективный, общий
җиңги - этногр, старшего
исерү - пьянеть, опьянеть
иганә - помощь, пособие
имнәү - имләү
сизем - чутьё
саегу - мелеть, обмельчать
илаһи - божественный, божество
еллап - около, года
чирау - покрываться, тонким
котып - полюс, полярный
адашу - заблудиться
бүксә - птиц
сөзәк - пологий, отлогий
алмаз - алмазный
иңкел - низменный, низменность
чолан - сени, чулан
чиләк - ведро, ведёрный
өлфәт - дружба, единство
кайсы - который, какой
бүкән - чурбан, тумба
чигеш - вышивка
мәңге - вечно, навеки
тараф - сторона
арчан - вереск
әйбер - вещь, предмет
андый - такой
шуышу - ползать, скользить
берле - единица, отметка
әкият - сказка, сказочный
таман - предик, спору
файда - польза, выгода
күгән - шарнир, пробой
идарә - управление, управленческий
абунә - абонемент
сөңге - копьё
туйра - дубок, молодой
сөтле - молочный, удойливый
битәр - больше
уртак - общий, совместный
шакшы - грязный, нечистоплотный
ханым - госпожа, дама
хисап - счёт, число
әртил - артель
кутыр - струп, короста
киртү - засекать, засечь
көмеш - серебро, серебряный
бөрмә - оборка, сборка
меңче - тысячник
галәм - вселенная, космос
маһир - мастер, умелец
сөлге - полотенце, полотенечный
өзешү - взаимно-совм, перен
җыючы - сборщик, собиратель
рәхәт - наслаждение, блаженство
савап - благодеяние, вознаграждение
шунда - тогда, заключается
юнучы - тесальщик
утлык - ясли, кормушка
кышкы - зимний
чәүкә - галка, галочный
салма - салма, клёцки
елсыз - раньше, через
йонча - мятлик, ворс
вакыт - время, пора
ешлык - частота, частота
дүдәк - дрофа
юлдаш - спутник, попутчик
бәлки - вводн, возможно
кәфен - саван, саванный
айлык - ежемесячный
бәбкә - гусёнок, утёнок
жикет - жакет
карый - Корана, наизусть
дәвер - эпоха, период
төксе - мрачный, сумрачный
бавыр - печень, печёнка
халык - народ, народный
әрләш - перепалка, перебранка
сагыш - тоска, грусть
анкет - анкетный
пестә - фисташка, фисташковый
миләш - рябина, рябиновый
ярату - любить, полюбить
беләү - оселок, бритвы
кайгы - горе, печаль
мәзин - муэдзин, служитель
кымыз - кумыс, кумысный
ислах - реформа
киңәш - совет, наставление
җизнә - старшей, сестры
итенү - рисоваться, кривляться
күрем - менструация, месячные
шаһит - свидетель, очевидец
чәмчә - кайма
эшчән - работящий, трудолюбивый
төзек - исправный, благоустроенный
бөреш - пешня
боеру - приказывать, приказать
тезем - цепь, цепочка
кунык - налёт, пыли
бушаю - ослабевать, ослабеть
юмарт - щедрый
ходай - господь, божий
ясмык - чечевица, чечевичный
капка - ворота, калитка
юрган - одеяло, одеяльный
чүгәү - чүгәләү, становиться
җофар - выхухоль, выхухолевый
аспид - аспидный
сөрән - этногр, конные
иртән - утром
тарак - гребень, расчёска
кереш - тетива, лучок
гавам - народ, масса
ачыгу - проголодаться, захотеть
урлау - воровать, красть
һични - һичнәрсә
ныклы - крепкий, твёрдый
төрек - турок, турецкий
канлы - сложн, переводится
әрләү - бранить, побранить
азлык - недостаточность, недостаток
антик - античный
орчык - веретено, веретённый
сагаю - настораживать
остаз - учитель, наставник
нечкә - прям, перен
артта - позади, сзади
акбүз - миткаль, миткалевый
чумар - клёцки, клёцками
фалчы - гадальщик, ворожей
газиз - дорогой, милый
бетчә - прыщ, угорь
мөгез - рожок
ачыну - горевать, печалиться
нокта - прям, перен
курпы - отава, отавный
тишек - дыра, отверстие
бәләк - валёк, бельевой
нәшер - издание
аңсыз - несообразительный, непонятливый
карар - решение, постановление
кушуч - пригоршня
катиб - секретарь
рәтле - толковый, путный
олпат - величественный, авторитетный
мичче - печник
өчаяк - таган, тренога
утрак - оседлый
тупса - шарнир, дверная
иртүк - раненько, спозаранку
чабыш - бега, скачки
җирдә - умножении, количественных
уйчан - задумчивый, задумчиво
көдрә - кудри, кудрявый
үкерү - реветь, завывать
даулы - спорный, скандальный
дәрес - урок, занятие
җигем - упряжка
җәймә - простыня, раскатка
бирле - с тех пор
элгеч - вешалка, крюк
узган - минувший, истёкший
ипләү - приспособляться, приспособиться
өйсез - бездомный, бесприютный
мәһәр - этногр, калым
биюче - танцор, плясун
көзли - осень
өреле - наварный, наваристый
зарлы - горестный, печальный
хаклы - имеющий, право
сызма - эскиз
аңышу - уразуметь, опомниться
учлам - клок, горсть
чалыш - кривой, косой
өшәнү - изнуряться, изнуриться
озату - провожать, проводить
бозык - перен, испорченный
ләңкә - тявкушка
үзбәк - узбек, узбекский
хәләл - дозволенный, разрешённый
тагын - опять
әтрәк - драный, обтрёпаный
фирка - группа, секта
кошчы - птичник, птичница
койка - студень, холодец
бурлы - чалый, гнедочалый
сыңар - единственный, перен
суган - луковый
катыш - перемешанный, смешанный
җария - рабыня, раба
берни - ничто, ничего
хокук - право, правовой
сугым - убойный, забой
хаҗәт - нужда, надобность
каксу - плесневеть, заплесневеть
кырыс - суровый, строгий
түшәк - перина
төкле - волосатый, пушистый
какма - колотушка
гаҗәп - изумительный, удивительный
тыгыз - тесный, тесно
таҗлы - венценосный
төнен - ночью
ишсез - непарный
телче - языковед, лингвист
бәпкә - баабка, снрпы
халәт - состояние
бөтен - целый, цельный
рәнҗү - сильно, обидеться
курын - зыбка, ловли
матәм - траур, скорбь
атыну - качаться, покачиваться
тышча - оболочка
яшьле - слезящийся, заплаканный
мичкә - бочка, бондарный
көләч - улыбающийся, весёлый
аксак - хромой, хромоногий
тәмам - предик, конец
көбәк - ствол, ружья
ягыну - намазываться
сусау - прям, перен
лепкә - родничок, ребёнка
зураю - увеличиваться, увеличиться
бөркү - прыскать, прыснуть
чибәр - красивый, красиво
айнык - трезвый
пыяла - стекло, стеклянный
эрләү - прясть, напрясть
бәйге - скачки, сабантуе
югары - высокий, высоко
юртак - рысак, рысистый
төкчә - волосок, ворсинка
абруй - честь, авторитет
уелма - выем, выемка
тәмле - вкусный, вкусно
рухлы - воодушевлённый, одухотворённый
асылы - хорошее
фәлән - такой-то, некий
әйтик - вводн, скажем
азгын - избалованный, безнравственный
чебеш - перен, замухрышка
парлы - парный, чётный
аэроб - аэробный
алдар - алдакчы
китем - расход
перес - брысь!
казан - котёл, котельный
төшке - полуденный, обеденный
кырчы - полевод
төнәү - настояться
җылым - невод
үрәчә - грядки, разводы
пышын - тихо, шёпотом
нәкыш - узор, орнамент
әрмәк - армяк, армячный
үлүче - умирающий, смертный
хәтәр - опасный, опасность
армый - неутомимый
кичен - вечером
алдын - алдынгы
каеру - отдирать, отодрать
хәстә - болезнь, больной
сузан - долговязый, длинный
хәлле - сильный, здоровый
болын - луговой
малай - мальчик, мальчиковый
көенә - көенчә
ермак - канава, промытая
бозау - телёнок, перен
кичкә - вечеру, вечер
тырпы - ощетинившийся, взъерошенный
тыныш - дыхание, пауза
камыт - хомут, хомутный
йөкле - гружёный, грузом
иптәш - товарищ, приятель
елтыр - блестящий, сверкающий
илһам - вдохновение, воодушевление
ыспай - аккуратный, опрятный
аулак - укромный, безлюдный
берек - объединение, союз
ботка - каша
йотым - глоток
бөкре - кривой, горбатый
берүк - обязательно, умоляю
җәяле - лучковый, пила
сыешу - умещаться, вместиться
юксыл - бедный, неимущий
тозлы - солёный, пересоленный
үрчем - приросток, приращение
герле - гиревой
ындыр - гумно, рига
алтау - шестеро, вшестером
карап - соответствии, соответственно
адрес - адрес
качак - беженец, беглец
өзелү - страд, рваться
мазар - второй, компонент
борма - излучина, изгиб
гәрчә - хоть
сәнәк - вилы, инструмент
сыену - льнут, прильнуть
келәм - прям, перен
йөреш - ходьба, хождение
каләм - стальное, птичье
чәпчү - расплескаться, перен
аерым - отдельный, раздельный
тырыш - старательный, усердный 
карга - ворона, вороний
ачлык - голод, голодовка
әйдәү - брать, собой
үтләү - объедаться
сөаль - вопрос
капыл - внезапно, вдруг
афган - афганский
көшел - куча, ворох
аннан - оттуда, затем
изелү - мяться, измяться
биләм - болтаться, шататься
гаярь - храбрый, смелый
чәчән - народный, певец
түгел - только
кайда - где
өрелү - страд, надуваться
боҗыр - рябчик
чыбык - прут, прутяной
какчы - пастильщик
базар - базар, рынок
ялгыш - ошибка, оплошность
охшаш - похожий, подобный
төялү - грузиться, набиваться
көпшә - труба, трубка
очкак - летучий, летучка
башка - другой, иной
әсбап - прибор, приспособление
көзгә - осени
сүрән - плохо, истопленный
тугай - извив, излучина
кабих - кабахәт
әдәби - литературный
варис - наследник, преемник
кубыз - комуз
аморф - аморфный
сабый - прям, перен
уелыш - разрез
томан - туман
дәлил - доказательство, аргумент
тамчы - капля, капель
казак - казак, казачий
кәнди - миска
түшәм - прям, перен
күпкә - надолго, долгое
бәрән - ягнёнок, барашек
күбәү - множество, много
йонлы - покрытый, шерстью
зиһен - разум, сознание
бизәү - красить, разрисовывать
үрдәк - утиный
кайма - кайма, оторочка
сөенү - радоваться
бәйле - завязанный, привязанный
төсле - цветной, похоже
җаһил - невежественный, двуличный
өслек - поверхность, поверхностный
җилем - клеевой, желатин
күксү - плесневеть, заплесневеть
киная - иносказание, намёк
ызгыш - ссора, дрязги
чияли - глухим, узлом
сулау - увлажнять, смочить
алаша - мерин
тотыш - поведение, манера
балку - сиять, светить
аунау - валяться, проваляться
кочау - обнимать, обнять
камыл - стерня, стернь
вәхши - дикий, дикарь
хәтер - память, хәтердә
бозлы - ледяной, градовый
аңкау - благоухать, издавать
ышану - верить, веровать
бәдән - тело, телосложение
өлгер - расторопный, проворный
рәхим - милость, милосердие
кибән - стоговый
юклык - неимение, отсутствие
ясану - наряжаться, прихорашиваться
айлап - около, месяца
хәбәр - весть, известие
фәһем - интеллект, разум
колач - объятие, охват
тоташ - сплошной, сплошь
дәлия - георгин
балта - топор
өркәк - пугливый
колга - шест, жердь
колын - жеребёнок, жеребячий
шадра - рябой, щербатый
шөпшә - осиный
күзчә - глазок
эләгү - цепляться, зацепиться
кечек - слабый
кадим - старинный, древний
әхлак - нравственность, мораль
сарыф - расход, трата
чагым - искра, искровой
түләү - платить, оплачивать
балан - калина
тырма - грабли, борона
бүрек - шапка, папаха
тәпән - небольшая, кадка
иблис - сатана, дьявол
дежур - дежурный, дежурство
киштә - полка, полочка
торна - журавль, журавлиный
әнкәй - мама, мамочка
надан - неграмотный, безграмотный
намаз - намаз, богослужение
бәвел - моча
данлы - знаменитый, известный
аяклы - ножками, зеркало
аерча - развилина, развилка
аңлау - понимать, понять
илерү - вопить, реветь
чишмә - родник, родниковый
төрки - тюркский, тюрки
узыну - зазнаваться, выходить
савыт - посуда, сосуд
бишле - пятилинейный, лампе
тиккә - даром, бесплатно
чабак - плотва, сорожка
басма - ступень, ступенька
косык - блевотина, рвота
дәрья - широкая, перен
җәелү - страд, разливаться
карау - смотреть, посмотреть
кытык - щекотка
очлык - наконечник, конечность
аванс - авансовый
күнәү - соглашаться, уступить
имәнү - вздрогнуть, сильного
этенү - толкаться
ашалу - размыв
нугай - ногаец
алучы - получатель
кәвеш - кявуши, национальная
аршын - аршин
алдау - обманывать, обмануть
күчеш - переход
хәрәм - запретный, запрещённый
пычкы - пила, инструмент
кемсә - кто-то, человек
бушка - попусту, впустую
селте - щёлочь, щелочной
ялану - облизываться
һаман - время, всегда
хәтфә - бархат, бархатный
турта - накипь, варке
кәттә - гордый, важный
заман - время, эпоха
камил - совершенный, безукоризненный
сүлле - серозный
таплы - прям, перен
оешма - организация
калҗа - кусок, ломтик
тирле - потный
яклау - защищать, защита
табыр - табор
чәшке - норка, норковый
дулау - бушевать, перен
ботак - ветвь, ветка
ыһһем - звукоподражание, кашлю
күшек - кресло
җиңгә - этногр, старшего
азыну - озорничать, безобразничать
уклау - скалка
ачкыч - замочный, гаечный
майчы - торговец, маслом
карья - деревня
нидер - нечто, что-то
җөйче - швея, белошвейка
ябага - шерсть-линька, линька
ихата - изгородь, плетень
фәләк - небосвод, судьба
көчәю - усиливаться, усилиться
кырпу - опушка, выпушка
оныту - забывать, позабыть
кысан - тесный, узкий
сәдәп - пуговичка, перламутр
яулык - платок
сөялү - прислоняться, облокотиться
уңнан - справа
җанлы - прям, перен
бөтәю - становиться, стать
алпан - тилп?н-вперевалку
сурәт - изображение, рисунок
укыну - читать, себя
тотам - пучок, ладонь
яңару - обновляться, подновиться
лайла - слизь
корыч - сталь, стальной
ялган - ложный, лживый
тураю - выпрямляться
ирегү - утомляться, утомиться
көрпә - отруби, высевки
арыту - ардыру
хәреф - буква, шрифт
кисмә - разрезной
барыш - процесс, течение
әүлия - святой, угодник
күчмә - движущийся, переходящий
ясалу - страд, образовываться
егылу - падать, упасть
бистә - слобода, пригород
сихер - прям, перен
сулда - налево, влево
сусын - жажда
куеру - густеть, загустеть
сынык - сломанный, обломок
үчегү - таить, злобу
чәнчү - колоть, вколоть
ихлас - искренность, чистосердечие
букча - сумка, ранец
җитез - проворный, расторопный
таҗик - таджик, таджикский
нәсер - проза, стихах
фасыл - время, раздел
сутлы - вязкий, жирный
чынга - всерьёз
кәбен - этногр, кябин
божан - шершень
тәрәт - экскременты
кызыл - красный, красный
сүнек - тусклый, померкший
табан - стопа, ступня
түбән - низкий, низко
җуелу - стираться, стереться
сөюче - любящий, любитель
итсез - постный, худощавый
ногыт - бобовый
кузый - ягнёнок, барашек
яткан - лежалый, товар
төпчү - разбирать, расспрашивать
такта - доска, дощатый
сихри - сихерле
тузгу - взлохмачиваться, растрепаться
иренү - лениться, полениться
кисеш - драка, резня
аклан - поляна, прогалина
ләгән - тазик
очрак - случай
аракы - водка, водочный
чыгыр - блочный, колесо
әфьюн - опий, опиум
иркәк - самец, мужчина
чөлли - четверть, четвертушка
сорау - спрашивать, спросить
ялмау - прям, перен
туену - питаться, кормиться
затлы - знатный, знатного
атлап - шагом
нәфес - алчность, ненасытность
галим - учёный
ярлык - ярлык, ханская
убылу - проваливаться, обваливаться
чыршы - еловый
симез - жирный, тучный
китән - полотно, полотняный
йөзәр - по сто, плавает
җидәү - семеро
талау - грабить, ограбление
ифрат - очень, весьма
кочак - объятие, охапка
бикрә - осётр
арата - поперечина, перекладина
җилкә - затылок, затылочный
чатак - неправильный, ненормальный
үрелү - виться, сплестись
елдам - ловкий, проворный
даими - постоянный, неизменный
түтәл - гряда, грядка
тулай - общий, валовой
кырын - набок, набекрень
кимек - мозговая, кость
җирле - местный
әрәтә - сотов
бакра - куколь, сорняк
төртү - тыкать, толкать
сыеру - сыдыру
кашык - ложка, ложечный
сауры - кожа, выделанная
эңгер - эңгер-меңгер
такыр - ровный, укатанный
сусар - куница, куний
тәүге - первый, изначальный
патша - прям, перен
манчу - макать, макнуть
чегән - цыган, цыганский
барча - весь
кәпәч - каляпуш, головной
бирнә - подарок, жениху
албан - албанский
өргеч - кузнечный
бүген - сегодня, ныне
телле - языкастый, острый
җирән - рыжий
коену - купаться, искупаться
кылыч - сабля, шашка
өйдәш - соквартирант, сожитель
шелтә - упрёк, выговор
кисәк - кусок, кусочек
көрси - кресло, скамья
иңкәю - наклоняться, наклониться
көрәю - тучнеть, становиться
талку - мять, трепать
әүвәл - раньше, прежде
тукта - предик, хватит
алтын - золотой, золотой
этлек - подвох, подлость
куйчы - чабан
агылу - течь, сыпаться
отылу - оттыру
гасыр - столетие
карак - жулик, воровской
вафат - кончина, смерть
болан - олень, олений
өермә - вихрь, вихревой
эзсез - вести, бесследно
ашкын - стремительный
сырлы - резной, рифлёный
яшәеш - бытиё
ерылу - страд, прорываться
иңрәү - стонать, стенать
салым - налог, подать
йончу - утомляться, утомиться
төдәш - однородный
төрчә - подвид, подкласс
җөмлә - предложение
көймә - лодка, шлюпка
үлгән - умерший, мёртвый
янгын - пожар, пожарный
артым - увеличение, привес
язышу - переписываться, переписка
мәңге - вечно, навеки
унлап - около, десяти
биләү - биләүсә
тоелу - чувствоваться, ощущаться
айгыр - жеребец, жеребцовый
чәйче - чаевод, чаёвник
акшар - белила, меловой
солых - мирный
тәртә - оглобля
талаш - ссора, скандал
ашлык - хлеб, хлеба
буена - буенча
иннек - румяна
үрнәк - образец, образцовый
шыңшу - скулить, визжать
юанаю - толстеть
торба - труба
үтмәс - тупой, неострый
өелмә - дамба, насыпь
сәбәп - причина, повод
өстәү - добавлять, дополнить
сыныш - преломление
акрын - медленный, тихий
какча - сухопарый, худощавый
исрәю - тупеть, отупеть
җиләс - прохладный, свежий
ялкын - пламя, перен
вәзир - визирь, министр
вөҗүд - существование, бытие
куыру - жарить, зажаривать
камау - окружать, окружить
көрәү - грести, сгрести
кабым - кусок
хәлвә - халва, халвовый
уллык - сыновний
теләү - желать, хотеть
йөдәү - изводиться, известись
түзем - түземле, түземлек
нарат - сосна, сосновый
әчетү - ачыту
көлсу - подзолистый
көзен - осенью, осенние
сызгы - чертилка
ярпач - хвастливый, бахвал
комык - кумык, кумыкский
бетте - конец, кончено
күчәр - осевой, перен
колан - кулан, дикая
кораб - корабль, корабельный
буйлы - полосатый, полосками
дөрес - верный, правильный
үлчәм - мера, мерка
йөзем - виноград, виноградный
сырга - серёжка, соцветие
горур - гордый, горделивый
дистә - десяток
ашыгу - торопиться, поторопиться
язулы - записью, исписанный
нахак - напрасный, несправедливый
җирсү - тосковать, родной
катык - катык, национального
яралу - зарождаться, зарождение
дымлы - влажный, сырой
орыну - ударять, удариться
чебен - мушиный, детская
аркау - нити для уток
тирмә - юрта
аныкы - его
сәхнә - сцена, сценический
язучы - писатель, писательский
тәрәч - треска, тресковый
җыелу - страд, собираться
иярмә - сопряжённый
айкау - махать, махнуть
бәлеш - бэлеш, нацииональное
тәмгы - алчность
боҗра - кольцо, кольцевой
асалы - узорчатый, закладными
гозер - мольба, просьба
чыклы - росистый
елышу - подвигаться, подвинуться
сеңер - сухожилие
шаяру - шалить, озорничать
караш - взгляд, перен
төянү - грузиться
анысы - конечно
көйле - мелодичный, напевный
йомык - закрытый, сомкнутыйЮ
бурсу - преть, начинать
чүмеч - половник, черпак
сулга - налево, влево
шәһәр - город, городской
чапкы - сечка, тяпка
алдак - обман
кипшү - кипшенү
ничек - каким, образом
ашыру - претворять, претворить
ачучы - открытый
бирем - задание
һәвәс - страсть, желание
ансыз - неё, этого
инҗир - инжир, фига
җиңсә - нарукавник, рукав
кырку - стричь, постричь
яньчү - мять, расплющить
чүбек - очёски, охлопок
әйдүк - пожалуйте, добро
киерү - вразн, натягивать
шәраб - винный
койма - забор, ограда
киртә - жердь, изгородь
җыеру - морщить, сморщить
сүздә - словах
өндәү - уговаривать, агитировать
хатын - женщина, жена
быргы - труба, горн
агызу - лить, наливать
ямьле - красивый, живописный
уңган - дельный, деловитый
ягъни - то есть
кашка - звёздочка, белая
түшәү - стлать, расстилать
хәвеф - опасность, угроза
кайне - каене
пөхтә - опрятный, аккуратный
уйлау - думать, размышлять
шулай - правильно, вводн
атлас - атласный
шәхес - лицо, особа
кабер - могила, могильный
рашкы - снежная, крупа
тамак - горло, глотка
эскәк - пинцет, щипчики
ирешү - прям, перен
ястык - перина, перинный
пүлән - полено
илтер - смушка, мерлушка
зелпе - жимолость, жимолостный
үткен - острый, перен
мәнле - порядочный, добропорядочный
калку - возвышенный, высокий
ирлек - мужество, мужественность
хозур - веселье, весёлый
башак - колос, пойло
тарих - история, исторический
зирек - ольха, ольховый
селкү - отряхивать, отряхнуть
зурат - продолговатая, кладка
иркәм - любушка, милушка
кяфер - безбожник, гяур
әрсез - беззастенчивый, пронырливый
коелу - страд, прям
тупый - тупоносый, тупым
кәмит - спектакль, концерт
мирас - прям, перен
алиһә - богиня
зират - кладбище, кладбищенский
атышу - перестрелка
әткәй - папенька, папочка
күшәү - жевать, жвачку
уктай - стрелой
бодай - пшеница, пшеничный
икеле - двоякий, двойной
хәтта - даже
сазау - старых, девах
кибәк - мякина, мякинный
комар - азартная, азарт
янтык - боковой, кособокий
күмәч - булочка, булка
саңак - жабра, жаберный
аккүз - белоглазка, птица
еллык - годовой, годичный
корал - оружие, орудийный
мәкер - коварство, хитрость
рәсүл - посланник, пророк
ыргак - крюк, зацепка
борыс - брус, брусок
ишетү - слышать, услышать
эретү - плавить, таять
тирән - глубокий, глубоко
астар - подкладка, подшивка
йогыш - зараза
салчы - плотогон, сплавщик
бүлем - часть, отдел
бугай - кажется, будто
ураза - ураза, мусульманский
намус - честь, совесть
матча - матица, балка
тупчы - артиллерист
җәнап - превосходительство
күчән - кочан, кочерыжка
очлау - острить, заострять
чирак - скрученный, туго
барсы - все, каждая вещь
читән - плетень, изгородь
болак - ручей, ручеёк
өферү - дуть, дунуть
каһәр - проклятие, злоба
кылый - косой, косоглазый
имана - подушный, надел
киңсу - широковатый
елдаш - яшьтәш
лачын - прям, перен
чакта - когда
рәсми - официальный, официально
гарәп - арабский
тыңчы - лазутчик, шпион
инсан - человек
йөгән - прям, перен
толып - тулуп, тулупный
әрмән - армянин, армянский
күкәй - клетка, птиц
өйлек - предназначенный, материал
гүзәл - красивый, прекрасный
алача - пестрядь, пестрядина
куану - радоваться, обрадоваться
җизни - старшей, сестры
мөһер - печать
ямалу - страд, заживать
атлам - поступь, походка
рәвеш - образ, облик
иҗади - творческий, созидательный
төпсә - пенёк, корешок
хаким - повелитель, властелин
тибеш - биение, толчок
төнге - ночной
кебек - будто, будто
айчык - узор на орнаменте
кырый - край, закраина
табыш - находка, прибыль
сабан - плуговой, пахота
төпке - глубинный, нижний
әгъза - член, орган
очлап - кусками, цугом
күрән - осока
сүтек - распоротый, распоротое
үзлек - свойство
акбур - меловой, мелок
сытык - раздавленный, смятый
таныш - знакомый, знакомый
ризык - пища, съедобное
тутый - прям, перен
читек - ичиги, сафьяновые
хирыс - пристрастный, охочий
мамык - хлопок, хлопковый
буяну - краситься, покраситься
агару - белеть, побелеть
бүлек - отдел, часть
алыну - страд, вызваться
карын - желудок, желудочный
борыч - перец, перцовый
очкын - искра, искровой
атлау - пахтать, масло
көхәл - сурьма, сурьмовый
фикри - мыслительный, умственный
хәзер - сейчас, теперь
тыныч - спокойный, тихий
ярдәм - помощь, подмога
төзәү - целить, наводить
азлап - помоленьку
уйнау - прям, перен
текмә - частокол
кысыр - яловая, нежерёбая
буялу - страд, пачкаться
хөкем - судебный, приговор
яшьли - смолоду, очень
кыялы - скалистый
ачулы - гневный, злой
җәзбә - циркуль, циркульный
иенке - поникший, повисший
төрән - лемех, сошник
күнәк - бурдюк
челән - цапля, перен
бизәк - узор, отделка
сөлек - пиявка, пиявочный
мөшкә - лоток, насыпь
сүзле - словосочетаниях, соответсвует
мыжык - ворчливый, брюзгливый
мисал - пример, иллюстрация
көтек - куцый, плохой
диләр - вводн, говорят
урман - лесной
фарсы - персидский
танау - ноздря, животных
бирге - ближний, близлежащий
көзге - зеркало, зеркальный
хәлдә - в силе
җиләү - вконец, устать
укмаш - скомканный, сбитый
килеш - падеж, падежный
көлеш - всех
яңгыр - прям, перен
очрау - попадаться, навстречу
милли - национальный
архей - архейский
кыллы - волосяной, струнный
табиб - врач, лекарь
ташлы - каменистый
саран - скупой, прижимистый
зәвык - прекрасному, удовольствие
бибек - чибис, пигалица
күләм - объём, перен
күрек - красота, краса
китче - китсәнә
үткәч - спустя
котый - шкатулка, ларчик
кисем - сечение, разрез
чәкән - початок, вышивки
архив - архивный
ертык - рваный, разорванный
эчлек - подкладка
җыйма - собирательный
салат - солод, солодовый
бурыч - долг, задолженность
тентү - обыскивать, обыск
тасма - лента, тесьма
алыча - әлүчә
бетле - вшивый
гарип - калека, инвалид
төлке - прям, перен
көчле - сильный, сильно
ыргым - спорт, рывок
уйнаш - прелюбодеяние, разврат
янтаю - крениться, наклоняться
морҗа - труба, печная
күшәк - павильон, беседка
арткы - задний, последний
тикмә - пустой, простой
җиргә - наземь, вниз
чыгым - расход, затрата
хөрмә - финик, финики
сәрви - жёлтая, акация
никах - никах, мусульманский
кәлтә - ящерица, ящеричный
кадау - колоть, укалывать
юллык - предназначенный, дороги
базык - коренастый, крепкий
тарау - чесать, лён
керәч - фарфор, фаянс
утрау - остров, островной
борай - полба, полбенный
ватан - родина, отечество
мисез - безмозглый, тупой
ошату - одобрять, одобрить
утлау - выгон, выгул
кысла - рачий, раковый
чирәм - трава, лужайка
тигез - ровный, ровно
майлы - масленый, маслом
кырлы - гранёный
имчәк - женская, грудь
танык - свидетель
чакма - огниво, кресало
ябыну - накрываться, одеялом
нурлы - лучистый, лучезарный
балак - штанина
инкяр - отрицание
көрәш - борьба, сражение
санлы - численный, числовой
динле - религиозный, верующий
уймак - напёрсток
рәткә - подряд
армия - армейский
аулау - охотиться, поохотиться
комлы - песочный, песком
янына - рядом
ялгам - привой, прививок
матдә - филос, материя
фетнә - мятеж, бунт
җитен - льняной
табак - большая чаша
сымак - подобно, сочетании
чукыр - клест, клёстовый
төнлә - ночью
таләп - требование, притязание
зарур - необходимый, нужный
билге - метка, пометка
хәтле - до тех пор
миңле - родинкой
теләк - желание, охота
сыткы - прыщ, угорь
җитеш - обеспеченный, зажиточный
нукта - недоуздок
сигез - восемь, сложн
ботау - обрубать, обрубить
әкрен - акрын
филтә - фитиль
яралы - раненый
сулык - водоём
йөкче - возчик, извозчик
гүләү - гүелдәү
димче - советчик, уговаривает
ятлау - заучивать, наизусть
маллы - имеющий, много
ялгыз - одинокий, одиноко
кунак - гость, гостевой
аккош - лебедь, лебединый
бакча - садовый
аяныч - жалкий, скорбный
фатир - квартира, квартирный
чуман - короб
өткеч - выжигалка
җикән - рогоз, камыщ
язлый - весной
имләү - этногр, ворожить
сүсле - волокнистый
иркен - просторный, обширный
сагыз - сера, живица
армас - неутомимый, неустанный
сөрсү - протухать
аксым - белок, белки
алышу - алмашу, схватываться
чуалу - путаться, запутываться
аклау - выбелить, вымазать
җепсә - спица, перекладина
ыштан - штаны, кальсоны
бүртү - набухать, набухнуть
ачлай - голодный
төпле - пнистый, перен
учлау - зажать
ябулы - крытый, накрытый
берсе - кто-нибудь, кто-то
терәү - прям, перен
азман - бастард, помесь
тубык - щиколотка
этәрү - отталкивать, отстранять
төмән - десять, тысяч
кышын - зимой, зимнее
сеңел - младшая, сестра
чагыр - пестроглазый
охшау - походить, похожим
калым - этногр, калым
укыту - понуд, учить
яткын - залёжный
аякчу - онучи, портянки
чирле - хворый, больной
сырма - стёганый, стёганая
нисби - относительный
иңләү - охватывать, охватить
гайре - иной, другой
сарык - овечий, перен
кызау - лукошко, кузов
карлы - снежный, снеговой
төрле - разный, разнообразный
ләкин - однако, однако
аксыл - беловатый, белёсый
дисбе - тәсбих
һәлак - гибель, смерть
ятышу - идти, к лицу
күшәм - жвачка, жвачных
нәзек - тонкий, тоненький
кәлшә - отава, подсед
янәсе - вводн, якобы
имбир - имбирь, имбирный
бакчы - смотри-ка
фәнчә - научному, научно
очсыз - тупой, незаострённый
бакыр - медный, медяк
шөбһә - сомнение, подозрение
эшерү - задвигать
гаять - очень, весьма
инану - верить, убеждаться
откыр - смышлёный, одарённый
токым - порода, потомство
биетү - понуд, проучить
төбәк - край, сторона
әрлән - хомяк, хомячий
тынгы - покой, спокойствие
элгәр - предшественник
кыска - короткий, коротко
кәрәз - сотовый
иярле - осёдланный
гәудә - туловище, тело
моңаю - унывать, печалиться
төтәү - дымить, коптить
баягы - недавний, давешний
упкын - пропасть, бездна
козау - лукошко, кузов
канау - кровоточить, пойти
җенле - бешеный, бесноватый
үткел - перевал
изүче - угнетатель, эксплуататор
шаулы - бурный, шумный
зирәк - сметливый, смышлёный
өстәл - настольный
сыман - подобно, сочетании
чатан - хромой, хромец
чыгыш - выступление, выходка
чытыр - хворост, хворостяной
бөдрә - кудрявый, курчавый
комсу - супесчаный
яңача - по-новому
тәмуг - прям, перен
сакау - картавый, косноязычный
язмыш - судьба, доля
салам - солома, соломенный
хисле - чувствительный, эмоциональный
чатма - парча, парчовый
тышкы - прям, перен
йөртү - водить, возить
ачыту - саднить, жечь
кысык - тесный, узкий
начар - плохой, скверный
төптә - вводн, основном
аярга - щадить
орышу - ругать, обругать
ырмау - выем, выемка
бәкәл - беда, злоключение
вагаю - мельчать, умельчаться
аркан - аркан, канат
фәнни - научный
китап - книга, книжный
тәҗел - срочный, спешный
ялыгу - утомляться, утомление
артка - назад
азрак - маловато
куышу - бежать, наперегонки
уйнак - игривый, резвый
язылу - записываться, запись
титак - хромой
күкшә - сойка
фидия - фидия, пожертвование
хәйлә - хитрость, лукавство
кабат - вторично, повторно
бәхил - предик, прощаю
мәгәр - лишь, однако
кәлам - речь, слово
ишарә - жест, знак
киләп - сновальня, сновалка
өчлек - трёшка, тройка
сөртү - вытирать, обтереть
елгыр - ловкий, подвижный
үтенү - просить, упрашивать
дымсу - слегка, влажный
комач - кумач, ярко-красная
аткый - свинчатка
сәхрә - пустыня, поле
нәрсә - составе, н?рс?
мәчет - мечеть
яннан - сбоку
янәшә - рядом, смежный
кәтүк - катушка, шпуль
хәлфә - учитель, наставник
нәфис - изящный, прелестный
тышка - наружу
йөрәк - сердце, сердечный
урама - обмотка, обвязка
сөзмә - сюзьма, национальное
ымлау - подавать, знаки
яфрак - листовой
зарар - вред, вредность
тавыш - голос, голосовой
мәсәл - басня, басенный
кысым - давление, натиск
абага - папоротник
калгу - вздремнуть, дремать
хикәя - рассказ, повествование
сөтче - молочница
пәрдә - занавес, занавеска
бишәү - пятеро
каршы - противоположный, противолежащий
аерту - пропускать
көлле - всякий, каждый
табын - стол, накрытый
бохар - бухарский
теләп - охотно, желанием
игрек - игрек, буква
коючы - литейщик
белем - знание, познание
фахиш - развратный, распутный
керем - доход, приход
матур - красивый, красиво
бәяле - оценённый, дорогой
сабак - учёба, обучение
өянәк - приступ, пароксизм
ялгау - присоединять, присоединение
мокыт - безмозглый, бестолковый
уйнап - шутку
бирән - обжора, чревоугодник
кәҗүл - козловая, козловой
тирес - навоз, навозный
юшкын - накипь, осадок
җәтмә - перен, сеть
ниргә - венец, звено
шәбәю - усиливаться, улучшаться
эчерү - поить, напоить
бөҗәк - насекомое
юнәтү - исправлять, поправлять
турам - ломоть
эчтәң - изнутри, эченнән
яттан - наизусть, память
кинәт - внезапно, вдруг
әлеге - теперешний, настоящий
кавым - некоторое, время
тимер - железо, железный
чимал - сырьё, сырьевой
ядкәр - памятник, исторический
чирек - четверть, четвёртая
алдан - спереди, впереди
ишкәк - весло, вёсельный
динче - служитель, культа
имгәк - бремя, обуза
сузык - гласный
болыт - туча, облако
әфсен - заклинание, волшебство
йолку - дёргать, выдёргивать
тизәк - помёт, экскременты
ташчы - каменщик, каменотёс
эчләү - подшивать, подкладку
инҗил - евангелие
диелү - говориться, именоваться
йозак - замок, замочный
чүкеч - молоток, молот
өләшү - раздавать, раздать
унлык - десятка, десятирублёвый
өлкән - старший, взрослый
үсмер - подросток, отрок
бәхәс - спор, полемика
шытым - росток, всходы
өянке - ветла, плакучая
авыру - болезнь, заболевание
кәрлә - карлик, карликовый
шикле - подозрительный, сомнительный
әдрәс - адрас, бухарская
җилән - джилян
чыдам - стойкий, упорный
ипләп - удобно, устроиться
курку - бояться, трусить
кагаю - вялиться, сушиться
алмаш - смена, замена
арлар - удмурты
сөрмә - сурьма, сурьмяный
качыш - прятки
чыпта - рогожа, рогожка
үткер - үткен
шикәр - сахар, сахарный
сусыз - безводный
өрфия - сетчатое, покрывало
җимеш - плод, фрукт
сихәт - полезное, свойство
төтен - дымовой, дымок
шәхси - личный, индивидуальный
ияртү - увлекать, увлечь
катрә - капля
татлы - прям, перен
мәзәк - шутка, забава
камчы - плеть, плётка
бабай - дедушка, тесть
адәми - человеческий
эрләм - пряжа
әсәрү - удивляться, удивиться
кушма - смешанный, соединённый
өлкәр - астрон, стожары
тамыр - прям, перен
фараз - предположение, мнение
суыну - прям, перен
көлке - потеха, забава
борын - человека, животных
маңка - сопли, перен
торма - редька
ипсез - неудобный, несподручный
дөңья - свет, вселенная
бугаз - горло, гортань
бәсле - заиндевелый, покрытый
өммәт - последователь, приверженец
камса - хамса, камса
мөһим - важный, значительный
чират - очередь, черёд
кисәк - кусок, кусочек
күпчү - перекисать, перекиснуть
кырау - заморозки
асрау - держать, содержать
югалу - теряться, утеряться
саллы - тяжёлый, увесистый
сәләт - способность
шикмә - решетина, обрешетина
тараю - суживаться, затрудняться
ахмак - глупый, бестолковый
изрәү - прям, перен
тугыз - девять, сложн
чаткы - искра, искровой
уйсыз - бездумный, беспечный
тозак - силок, прям
кадәр - вплоть, сколько
чабар - гонец
җавап - ответ, ответный
тырыс - туес, туесок
аграр - аграрный
үзбаш - самостоятельно, самостоятельный
онлау - валять, обвалять
суыту - прям, перен
табут - гробовой
янчык - кошелёк
тоҗым - паутина, паутинка
фәхеш - разврат, прелюбодеяние
куныч - голенище, краги
ярпаю - бахвалиться, хвастаться
күбек - күбек, национальное
оятлы - постыдный, позорный
гөмбә - молочница, головня
фытыр - фытыр, подаяние
гөләп - гөлҗимеш
амеба - амёба
иңбаш - плечо, плечевой
яшәрү - молодеть, зеленеть
беләк - плеча, кисти
котаю - становиться, здоровым
төзәю - выпрямляться, распрямиться
җәпле - имеющий, развилину
чөнки - потому
очкыч - аэроплан, самолёт
яллау - нанимать, вербовать
сәяси - политический
юкару - утончаться, тончать
инәлү - умолять, упрашивать
серле - таинственный, загадочный
канун - канон, закон
торак - жилище, жилой
абхаз - абхазец, абхазский
эзләү - искать, разыскивать
кадак - гвоздь, гвоздевой
йөзмә - плавучий, плавающий
нихәл - дела, поживаешь
эшләү - работать, трудиться
терәп - вплотную
көмән - беременность
талак - развод, расторжение
ригая - уважение, почтение
хонса - гермафродит, обоеполый
карта - [къарта], толстая
кавык - перхоть
кискә - обрубок, кряж
атучы - стрелок
матди - филос, материальный
ачылу - страд, открываться
белән - со, вместе
артыш - можжевельник, можжевёловый
киңәю - шириться, расширяться
ирнәү - закраина, ободок
сәҗдә - земной, поклон
сугыш - война, военный
ыслау - окуривать, прокуривать
оялау - гнездиться, гнездо
сарку - сочиться, просочиться
курыс - лыковый
моңсу - грустный, навевающий
юллау - отправлять, направлять
давыл - буря, ураган
күңел - душа, сердце
ялыну - упрашивать, умолять
алкыш - аплодисменты, овация
үлчәү - мерить, измерять
билле - сшитая, талию
өчесе - всех
иснәү - нюхать, обнюхивать
сабыр - терпеливый, выдержанный
терәк - подпора, подставка
чарыс - резвый, лошади
малчы - скотовод, скотник
ләхет - могиле, могила
золым - гнёт, ярмо
очучы - лётчик, авиатор
серкә - уксус, уксусная
йомры - круглый, шарообразный
әлүчә - алыча, дерево
җенес - половой, племя
ургыч - жатка, жнейка
бергә - вместе, совместно
күлем - обеденный, перерыв
кибет - магазин, магазинный
ирләр - мужчины, мужской
җаный - милый, милочка
кесәл - кисель, кисельный
акыру - орать, горланить
кузла - козлы, пилки
атсыз - безымянный
өркәч - верблюда
җисем - перен, существо
нидән - отчего, почему
калып - колодка, обуви
төймә - пуговица, пуговка
ләвәш - лаваш, лепёшка
сәмих - камедь
сарай - дворец, хоромы
гакыл - ум
кавын - дынный
нәсел - родовой, племя
җыену - собираться, собраться
төрбә - склеп, усыпальница
әнчек - дворняжка
җитди - серьёзный, серьёзно
газап - мучение, страдание
мохит - среда, окружающая
тавык - курица, куриный
гидай - бедняк, бедный
кугын - погоня, гонец
кертү - вводить, ввести
тәңре - всевышний
чолык - борть, бортевой
тугаю - насыщаться, созревать
буран - буран, метель
атылу - выстрелить, произвольно
тулма - голубцы, блюдо
сирпү - слегка, метнуть
шимбә - суббота, субботний
чаңгы - лыжный
чүпле - сорный, засорённый
ихаха - охо-хо, го-го-го
уралу - мотаться, обмотаться
чүпрә - дрожжи, закваска
иңгән - впалый, щёки
газлы - газовый, газированный
тирәк - тополь, осокорь
чатыр - шатёр, шатровый
сынау - испытывать, пробовать