татар - татарин, татарка
рәсем - рисунок
сумса - сумса, национальное блюдо
гаилә - семья, семейство
мулла - мулла, служитель
чалма - мусульманская накидка
бүлмә - комната, кабинеты
балык - рыба
арзан - дешёвый
низаг - ссора
борау - сверло
фарыз - предположение, предписание
җырчы - певец, певица
бишек - колыбель, люлька
челлә - жаркая пора
черем - дрёма, дремота
аръяк - противоположная сторона
бүсер - грыжа
кизәк - кизяк, переработанный навоз
орлык - семя
тупыл - тополь
черки - комар
шырпы - спичка
төрем - завёртка
йомыш - поручение, задание
шулпа - бульон
кәсеп - занятие, ремесло
батыр - герой, богатырь
җомга - пятница, пятничный
ыштыр - портянка, онуча
киенү - одеваться, одеться
төрмә - тюрьма, тюремный
пычак - нож
даган - качели
сызым - чертёж, чертёжный
нигез - фундамент, фундаментный
дәвам - продолжение
әйрән - айран, напиток
күрше - сосед
шәүлә - блик, отсвет
әйбәт - хороший, хорошо
туган - родственник, родина
атама - название, наименование
көрән - коричневый, бурый
тәүбә - раскаяние, покаяние
тамга - знак, метка
йолым - выкуп, откуп
кәләш - невеста
ләүкә - полок в бане
чәчәк - цвет, цветок
амбар - житница
ялтыр - блестящий, сверкающий
татым - привкус
чалым - сходство, черты
көзән - хорь, хорёк
черек - гнилой, гниль
сукыр - слепой
көрәк - лопата
мунча - баня
яһүди - евреи
бәбәк - молодая ветвь
калай - жесть, жестяной
керпе - еж, ежик
тутык - ржавчина, ржавый
печән - сено, сенокос
калын - толстый
сакчы - сторож, страж
һөҗүм - нападение, набег
җиһаз - обстановка
берәү - кто-то, некий
казна - казна, казённый
дорфа - грубый, невежливый
ятимә - девочка-сирота
бәлеш - блюдо
кабык - корка
гомер - жизнь
камыр - тесто, мучной
кавем - родня, племя
тәхет - трон, престол
пеләш - плешь, лысина
сызык - черта, линия
абзар - хлев, стойло
үксез - сирота
келәт - амбар, склад
бәндә - человек
күмер - уголь
борча - блоха
басым - давление, напор
хөтбә - проповедь, хутба
сакал - борода
гамәл - дело, действие
йөзек - перстень, кольцо
курай - музыкальный инструмент
күпер - мост
сәүдә - торговля
гадәт - привычка, навык
бәхет - счастье, удел
сулыш - дыхание
колак - ухо
укучы - ученик, учащийся
чокыр - яма, воронка
казый - кадий, казий
гөнаһ - грех
якташ - земляк
фикер - мысль, намерение
бүләк - подарок
сабын - мыло
исбат - доказательство
кәкре - кривой, гнутый
тузан - пыль
тотык - заложник
ислам - ислам
әйбер - вещь, предмет
әкият - сказка, сказочный
файда - польза, выгода
хисап - счёт, число
чәүкә - галка
вакыт - время
миләш - рябина
капка - ворота, калитка
юрган - одеяло
тарак - гребень, расчёска
бетчә - прыщ, угорь
мөгез - рожок, рога
нокта - точка
тишек - дыра, отверстие
карар - решение, постановление
чабыш - бега, скачки
дәрес - урок, занятиеы
җәймә - простыня
бозык - испорченный
хокук - право
халәт - состояние
аксак - хромой
пыяла - стекло
абруй - честь, авторитет
казан - котёл
болын - долина, луга
ботка - каша
сәнәк - вилы, инструмент
карга - ворона
базар - базар, рынок
сабый - малыш
томан - туман
дәлил - доказательство, аргумент
түшәм - потолок
бәрән - ягнёнок, барашек
үрдәк - утка
хәтер - память
бәдән - тело, телосложение
хәбәр - весть, известие
бүрек - шапка, папаха
торна - журавль
надан - неграмотный, безграмотный
намаз - намаз, богослужение
савыт - посуда, сосуд
басма - ступень, ступенька
пычкы - пила, инструмент
яулык - платок
сурәт - изображение, рисунок
хәреф - буква
фасыл - время, раздел
кызыл - красный, красный
табан - стопа, ступня
ләгән - тазик
җилкә - затылок
түтәл - грядка
патша - король
кәпәч - каляпуш, головной убор
әүвәл - раньше, прежде
алтын - золотой
җөмлә - предложение
көймә - лодка, шлюпка
сәбәп - причина, повод
ялкын - пламя, перен
вәзир - визирь, министр
сәхнә - сцена
боҗра - кольцо
бирем - задание
хатын - женщина, жена
шәхес - лицо, особа
кабер - могила
кяфер - безбожник
рәсүл - посланник, пророк
бүлем - часть, отдел
ураза - ураза, пост
намус - честь, совесть
хаким - повелитель, властелин
үзлек - свойство
акбур - мелок
сытык - раздавленный, смятый
таныш - знакомый
ризык - пища
борыч - перец
хөкем - приговор
бизәк - узор, отделка
урман - лес
яңгыр - дождь
табиб - врач, лекарь
күләм - объём
төлке - лиса
морҗа - труба
күшәк - павильон, беседка
хөрмә - финик, финики
никах - мусульманский обряд, свадьба
ватан - родина, отечество
чирәм - трава, лужайка
балак - штанина
матдә - материя
фетнә - мятеж, бунт
табак - большая чаша
таләп - требование, притязание
ятлау - заучивать наизусть
ялгыз - одинокий
кунак - гость
бакча - сад
фатир - квартира
ыштан - штаны
тубык - щиколотка
сарык - овца
нәзек - тонкий, тоненький
бакыр - медь
гәудә - туловище, тело
өстәл - стол
чыгыш - выступление, выходка
тәмуг - ад
язмыш - судьба, доля
аркан - аркан, канат
китап - книга, книжный
фидия - фидия, пожертвование
мәчет - мечеть
кәтүк - катушка, шпуль
нәфис - изящный, прелестный
йөрәк - сердце
яфрак - лист
зарар - вред
тавыш - голос
кысым - давление, натиск
пәрдә - занавес, занавеска
табын - стол, накрытый
керем - доход, приход
матур - красивый, красиво
тирес - навоз
чирек - четверть
сузык - гласный
болыт - туча, облако
әфсен - заклинание, волшебство
йозак - замок, замочный
чүкеч - молоток
бәхәс - спор, полемика
шикәр - сахар
җимеш - плод, фрукт
төтен - дым, дымок
шәхси - личный, индивидуальный
мәзәк - шутка, забава
бабай - дедушка
тамыр - корень
фараз - предположение, мнение
көлке - потеха, забава
борын - нос
бугаз - горло, гортань
өммәт - последователь, приверженец
чират - очередь, черёд
кисәк - кусок
сәләт - способность
ахмак - глупый, бестолковый
җавап - ответ
очкыч - аэроплан, самолёт
канун - канон, закон
торак - жилище, жилой
кадак - гвоздь
талак - развод, расторжение
карта - карта
атучы - стрелок
сәҗдә - земной поклон
сугыш - война
давыл - буря, ураган
күңел - душа, сердце
алкыш - аплодисменты, овация
терәк - подпора, подставка
очучы - лётчик, авиатор
кибет - магазин
дөнья - мир, Земля
сарай - дворец, хоромы
кавын - дыня
нәсел - род, племя
әнчек - дворняжка
газап - мучение, страдание
тавык - курица
буран - буран, метель
шимбә - суббота
чаңгы - лыжи
чүпрә - дрожжи, закваска
чатыр - шатёр
сынау - испытывать, пробовать
кырау - заморозки
караш - взгляд
нарат - сосна
эремә - раствор
тәмам - конец